# #########################################################################
#                                                                         #
# #### ### ###################### ########### ###### #################### #
# #### ### ####                            ## ######   ########           #
#      ### #### #################### ########     ####        # ######### #
# ## #####                  ####     #        ### #### ###### # ###    ## #
# ## #   ################## #### ##### ########## #### ## ### # ### ## ## #
# ##   # ##########    #### ####       ######   # #### ## ###   ### ##    #
# ###### ########## ##      ################# ### #### ## ######### #######
# ##   #    ####### #######     b########         ####    ##   #### ##    #
# ## # # #####        ##### ############# ### ######## ##### # #### ## ## #
# ## #   ##### #### ####### #####         ###          ##    # #### #r ## #
#    #####     #### ####### ##### ####### ### ########### #### #### ##### #
# ## ###   # ###### ####### ##### #   ### ### ##          #### ####       #
# ##     ### #####                ###   # ### ## ############# #### ##### #
# #########  ##### ### ################ # ###    #######                # #
# ##    ###        ###    ######    ###   ############## ####### ###### # #
# ## ## ########## ######     ## ## ### ###########    # ####### ###### # #
# ## ## ########## ########## ## ##   # #   ##      ## # #######     ## # #
#                                #### # # # ## #### ## # ############## # #
# ## ########### #################### # # # ## #    ## #       ###   ## # #
# ## # ####      #################### #  r# ## # ## ## ####### ### # ## # #
#    # #### ######          ######### ##### ## # ## ##         ### # ## # #
# ##   #### ###### ########      ####       ## # ## ####### ## ### #    # #
# ## ####          ######## #### ############# # ## ####### ##   # ####   #
# ## #### #############     #### ###   ##      # ## ####### ######      ###
# ##      ######        # ######     # ## ###### ##            ############
# ##### ######## ######## ############ ##        ############# #####      #
# #####          ########b             #######################       ####  
###########################################################################