# #########################################################################
#      #####                                 #       # #######          r##
## ### ##### ################ ############## # ##### #      ## ############
## ### #####               ##      ######### #    b# ###### ## ##     ##  #
## ### ##### ####### ##### ################# ####### ###### ## ## ### ## ##
## ###           ###     # ###       #######         ###### ## ## ### ## ##
## ############# ####### # ### ##### ####### ### ### ##     ## ## ### ## ##
## ############# #       # ###    ##         ### ### ## ###### ## ### ## ##
##   ####        # ####### ###### ## ########### ### ##        ## ### ## ##
####      ########      b# #      ## ########    ### ######### ## ### ## ##
######### ################ # ####### ##       ######           ## ### ## ##
####      #####            # ####### ####### ####### ## ######### ##     ##
#### ########## ############ ###     ######  ####### ## ##        ## ######
#    ########## #r      #### ### ########## ######## ## ## ######### ######
# ## ########## #######      ### ####       ###      ## ## ######### ######
# ##                  ########## #### ## ###### ####### ##               ##
# ################### ##########      ## ###### ##      ######### ###### ##
#          ##########          #########        #######        ## ###### ##
# ######## ##      ########### ############################### ## ##     ##
#       ## ## ####      ######                           ##### ## ## ######
####### ## ##    # #### ##   ## ######################## ##### ## ## ###  #
####### ## ####### #### ## # ## ###        ##    ####### #     ## ## ### ##
##      ##         ####    # ## ### ###### ## ## #       # ### ## ##     ##
## ########## ############## ##         ## ## ## # ####### ### ## #########
## ##     ###           ######### ##### ##    #### #       ###            #
## ## ### ### ######### #####     #   # ########## ###################### #
## ##   #            ## ##### ##### # #         ##                      # #
## ################# ##     #       # ################################# ###
##                   ######   #######                                 #    
###########################################################################