# #########################################################################
# #                                                                       #
# # ##### # ############################################################# #
#   #   # #     #      # #    #                   #        #     #      # #
# ### # # ##### # #### # # ## # #################   ###### # ### ###### # #
#     # #     # # #    # #  # # #       #       #####      # # #      # # #
### ###########   # #### ## # # # ##### # #####       ###### # ## ### # # #
# #       #     ###       # ### # #   # #     ##### #        #    # # # # #
# # #### ## #####   ### #   #   #   # # #######     ######## #### # #     #
# # #    #  #     ###b# ##### ####### #         ###        #   r#   #######
#   # #### ###### #   #    #  # #     #########   ############### #       #
##### #    #      # ### ## # ## #######     #####               # # #######
#     ############# # ## # #    # #     # # #   ################# #       #
# #####   #      #  #  # # # #### # ##### # # #                 # ####### #
#       # ###### # ### #   # #    # #     # # ###################         #
#########        #   # ##### # #### # ##### # #   #               #########
#       # # ###### # # #r    # #    #     #   # # # ###############       #
# ##### # # #      #   ####### # ######## ##### # #                 #######
#     #   # # ##########       # #              # ###################     #
##### ##### # #       #  ##### # ################ #   #   #           ### #
#   #     #   # ### #   ##   #   #       #        # # # ### ###########   #
# # ##### ##### # # #####  # ##### ####### # ###### # # #   #   #     ### #
#         #     # #   #   ## # #           #        # # # ##### # ###     #
#### ###### ##### ### ## ##  # ###################### # # #   # # # #######
#           #     # #  # #  ## #                #     # #   # # #         #
# ########### ##### ## # # ##  # ####### ###### # ##### # # # # ######### #
#             #   #  # # # #  ##   # # # #    #         # # # # #   #     #
# # # ######### # ## # # # # ##  #   # #   ## # ######### # # # # # #######
#  b#           #    #   #   #  #  ###   ###  #           # #     #        
###########################################################################