#s#########################################################################
#                                                                         #
# # ############################# ################### ########### ####### #
# # #        #           #                          #       #   #       # #
# # # ###### # ##### ### # ##### ######### ######## # ##### # # ## # ## # #
# #        # # #   # #   # #     #       #        # # #     # #  # #    # #
# ######## # # # # # # ### # ##### ##### ###### # # # # ##### ## # # ## # #
# #        # # # # # #     # #     #            # # # #        #   # #    #
# # ######## # # # # ####### # ##### ############ #   # ###### ##### # ####
#                # # #       #                    ##### #      #     #    #
####### ########## # # ################# ########     # # ###### ###### # #
#                  #                            ##### #   #      #      # #
# # ############ ##########                     #     ##### # # ## ###### #
# #              #        ##########   ########## ## ##     # #           #
# #### ###### # ## # #### #          *          #  #    ##### # ####### # #
# #    #      # #  #    # ########## k ########### # ## #     # #       # #
# # #### #### # # ## ## # #                        #  # # ##### # ####### #
# #         # # # #     # ###########  ########## ### # # #h    #         #
# ######### # #   # ##### #                     #   # # # # # # ##### #####
#             ##### #     ############ ########## # #   # # # # #     #   #
#### ##########       ###      #       #      #   # # ###   # # # ### # # #
#               #######   # ## # ####### #### # ### #     ###   #   # # # #
# # ####### #####       ### #               # # #   #######   ##### # # # #
# #       #       # ###     # ############# # #   ###       ###   # # # # #
# # ##### # ####### #   ### #    #      #   # # # #   #######   # # # # # #
# # #     # #         #   #   ## # ## # # # # # # # #         ### # #     #
# # # # ### # ######### # #####     # # # #   # # # #### ######   # ### ###
# #   #                 #       # #   #     #   #   #           #         #
# ##### #### #################### ############# ##### ################ ## #
#                                                                         e
###########################################################################